推,噓,分數,作者,標題,時間
7,1,6,chart (まどか　ＮＯ.１ ＼(^O^)),[新聞] 台北大晴天！公館捷運站出口卻「下大雨」　民眾撩褲避積水,Sun Nov  1 10:44:11 2020
47,9,38,sleeeve (赴美留學的日子...),[問卦] 10公里慢跑跑53分鐘算怎樣呢?,Sun Nov  1 08:56:23 2020
2,1,1,BerserkerAxe (織織),[問卦] 誰是下一位受害者,Sun Nov  1 01:32:53 2020
13,1,12,e1447e (e1447e),[問卦] 灌籃高手放到現在還會是神作嗎？,Sun Nov  1 09:58:34 2020
2,2,0,XSR700 (39.8萬不買嗎?),[問卦] 反串不小心吸到真粉怎麼辦?,Sun Nov  1 10:11:24 2020
21,10,11,VOLK11 (VOLK),[新聞] 北市男童裸身疑遭虐未安置 目前仍與生父繼母住,Sun Nov  1 00:59:48 2020
3,0,3,hotaru3456 (白河),[新聞] 美售台岸防魚叉飛彈可拒敵境,Sun Nov  1 03:34:36 2020
131,30,101,kbten (kbten),[新聞] 長榮女大生命案 成馬來西亞華文媒體頭版,Sun Nov  1 09:32:47 2020
34,5,29,qwe60038 (OORさいこう),[問卦]  檢舉鄰居賭博 被警察出賣的八卦,Sun Nov  1 01:24:55 2020
1,1,0,voncroy (niflheim一律打趴武力放),[問卦] 是不是很多宗教其實都在搞性活動?,Sun Nov  1 01:32:41 2020
5,3,2,ReiFu21 (ReiFu),[問卦] 鬼滅劇場版給迪士尼來拍有搞頭嗎？,Sun Nov  1 10:12:00 2020
4,0,4,arscerate (萬與雪飄),[問卦] 有沒有喜憨兒基金會的卦,Sun Nov  1 01:13:31 2020
5,9,-4,KouChouChing (20分鐘),[新聞] 拜登兒醜聞傳造假 柯文哲提美疫情確診數,Sun Nov  1 09:52:41 2020
11,8,3,hahaopen (chun),[問卦] 幹比自己小11歲的女生  會有罪惡感嗎,Sun Nov  1 01:30:01 2020
2,1,1,rockon15 (水之呼吸－炭治郎),[問卦] 台南最近多災多難 是不是肉臊飯害的？,Sun Nov  1 09:56:22 2020
4,1,3,BlueGiant (極簡風格 藍巨人),[問卦] Google現在還是創新聖地嗎？,Sun Nov  1 00:31:56 2020
5,6,-1,zxcvbbb ( ),[新聞]一家最後合照曝 女大生媽淚：台灣還我女兒,Sun Nov  1 11:21:16 2020
7,0,7,CavendishJr (真禮梅西姐姐♡),[問卦] 美洲獅梅西的慶生影片,Sun Nov  1 09:51:18 2020
4,1,3,Dinenger (低能兒),[問卦] 沒人覺得一輩子工作很可怕嗎！,Sun Nov  1 03:29:17 2020
113,13,100,leo1990910 (魯刺客 Leo l'assassino),代號「X-,Sun Nov  1 07:02:52 2020
7,2,5,pp771017 (橫艾),[問卦] 有沒有天上碑的八卦？,Sun Nov  1 03:36:43 2020
12,4,8,wizard12379 (聖光會護佑我),[爆卦] 天鵝颱風成為21世紀以來的風王,Sun Nov  1 04:46:24 2020
9,1,8,kiki1219 (=大坪林書豪=),[問卦] 如何安慰象迷朋友？,Sun Nov  1 09:03:31 2020
13,18,-5,sukiyasuica (suica),[新聞] 安心旅遊補助結束 旅行業：恐撐不到過年,Sun Nov  1 08:48:25 2020
5,1,4,cc02040326 (茶包),[問卦] 我老婆變石頭了該怎麼辦？,Sun Nov  1 00:33:56 2020
81,1,80,poeta (鍵盤詩人),[問卦] 有遊戲間 點心間 休息間的公司真的存在嗎,Sun Nov  1 00:49:35 2020
5,0,5,currry (南港李國毅),[問卦] 警察是不是專心維護治安就好,Sun Nov  1 00:43:59 2020
11,12,-1,bagafuok (噗噗),[問卦]  泰國已經超越臺灣了嗎?,Sun Nov  1 10:03:22 2020
75,9,66,gedian (隨風飄零),[問卦] 跟風老警察吃案,Sun Nov  1 03:44:41 2020
0,3,-3,seth5421 (正版廢文王),[問卦] 如果可以改一次id大家會改什麼,Sun Nov  1 10:30:31 2020
10,1,9,cruelgentle (Heidelberg),[新聞] 氣炸！李蒨蓉又失言「許多流氓無賴都是佛教徒」,Sun Nov  1 04:04:16 2020
10,2,8,amy93 (silence),[問卦] 志效又美出新高度了？,Sun Nov  1 00:21:29 2020
28,2,26,blue999 (民國詩人-Blue居易),[問卦] 姦殺案發生原因， 在於男女設計不良吧,Sun Nov  1 00:59:07 2020
1,4,-3,sleeeve (赴美留學的日子...),[問卦] 洋妞484可以很騷阿,Sun Nov  1 01:04:09 2020
6,7,-1,gracew0709 (suprasegmental),[問卦] 0.0 傻傻的 會吸引帥哥的注意嗎☺,Sun Nov  1 02:24:14 2020
5,0,5,scottaa (小獵人),[問卦] 這是什麼蟹,Sun Nov  1 00:31:25 2020
10,3,7,YenFuOne (焉芙丸),[問卦] 月薪8萬的專員 vs 月薪6萬的經理,Sun Nov  1 10:43:04 2020
12,1,11,ZMittermeyer (ZM),[問卦] 臺灣經濟到底是好還是不好啊？,Sun Nov  1 00:37:26 2020
0,0,0,CREA (自由滞在),[問卦] 元乃木坂46白石麻衣開IG了,Sun Nov  1 11:30:59 2020
3,3,0,yangzy (亞瑟),[問卦] 如何教化不相信警察都不會吃案的民眾？,Sun Nov  1 08:18:29 2020
11,6,5,Emacs (打馬小蝦兵),[問卦] 如果給你執政，你怎處理社會的未爆彈？,Sun Nov  1 10:10:03 2020
4,0,4,sunbox1019 (黑暗希望 ),[新聞] 女兒魂斷台灣 母盼凶嫌被判絞刑「一命償,Sun Nov  1 00:35:18 2020
4,1,3,ForTheHorde (為了部落！),[問卦] 這國外影片怎麼做的?,Sun Nov  1 02:12:19 2020
1,2,-1,"god46 (大家好,我是JayJay林俊傑)",[問卦] 聽說每天都有節日，今天慶祝什麼？,Sun Nov  1 11:19:03 2020
1,1,0,goldenhill (我的人權時代),[新聞] 大灣區建設沒吸引力？七成企業擬遷廠,Sun Nov  1 11:28:49 2020
2,3,-1,great5566 (陳央),[新聞] 他告白警察遭諷「玫瑰捅屁眼」　高雄警被,Sun Nov  1 10:42:31 2020
2,0,2,dodo52woman (嘟嘟左右衛門),[新聞] 家屬慟：規劃來台參加畢典變認屍,Sun Nov  1 08:17:19 2020
7,6,1,kbt2720 (master),[問卦] 住101旁邊很衰小的卦,Sun Nov  1 00:43:39 2020
11,2,9,lpbrother (LP哥(LP = Love & Peace)),[問卦] 鄉民要集資去馬來西亞打廣告嗎？,Sun Nov  1 10:57:32 2020
3,10,-7,start9963 (失火啦火葬場啦),[問卦] 整天喊死刑不就跟中國一樣,Sun Nov  1 10:39:51 2020
26,6,20,yoseii (yoseii),[新聞] 長榮女大生遇害 父親盼嚴懲凶手防止類似不幸,Sun Nov  1 02:05:50 2020
1,1,0,AgentSkye56 (大安周渝民),[問卦] 台南房價是不是又要井噴了,Sun Nov  1 08:51:48 2020
2,1,1,ptt987654321 (),[新聞] 勒斃長榮女大生！台南惡狼住家遭蛋洗 親,Sun Nov  1 10:16:42 2020
4,4,0,diok (幻影),[問卦] 台灣人是不是能體會印度人的心情了?,Sun Nov  1 11:25:42 2020
1,0,1,redspeed (RED),[問卦] 釣到沼澤之王然後哩?,Sun Nov  1 11:27:45 2020
16,8,8,skizard ( ),[新聞] 林佳龍任台大國發所客座講師 談政府創新,Sun Nov  1 08:41:58 2020
39,26,13,BerserkerAxe (織織),[問卦] 我覺得我撐不下去了,Sun Nov  1 02:30:31 2020
0,0,0,ptt987654321 (),[問卦] 仇女、仇甲、單身、肥宅交集為什麼會這麼,Sun Nov  1 11:01:06 2020
3,0,3,autokey (該起床啦),[問卦] 東方快車跟無限列車哪個CP值比較高的八卦,Sun Nov  1 00:42:47 2020
43,3,40,michaeldrum (Syncopation),[問卦] 去新竹一天能幹嘛啊,Sun Nov  1 04:58:57 2020
5,1,4,suhu5566 (),[問卦] 當初抗爭不要捷運經過的居民現在在想什,Sun Nov  1 08:52:19 2020
239,0,239,Mariano42 (Mariano Rivera),[問卦] 為啥美國投票是在平日？,Sun Nov  1 02:42:50 2020
517,72,445,zuan (Hello),[爆卦] 超越連戰的舉球手出現啦！,Sun Nov  1 09:08:20 2020
32,3,29,ppppppppp (凹嗚嗚),[新聞] 校慶溜充氣滑梯闖關　苗栗多名學生扭傷挫嘆：校方硬逼溜,Sun Nov  1 10:55:58 2020
13,3,10,lianpig5566 (家庭教師殺手里包恩),[問卦] 學生辦信用卡的人多嗎,Sun Nov  1 02:09:59 2020
18,7,11,rs5556 (懶叫好吃^Q^),[新聞] 取名很重要！帶貓打預防針 獸醫猛問：你,Sun Nov  1 01:15:35 2020
9,1,8,taiwannext (2016綠營重新執政 ),[問卦]川普任命大法官將讓他順利連任美國總統？,Sun Nov  1 08:54:05 2020
4,5,-1,autokey (該起床啦),[問卦] 在火車上對談但眼睛不看人沒禮貌的八卦?,Sun Nov  1 00:33:27 2020
4,8,-4,keyesleo (以前曾經很帥),[問卦] 各位有這樣的朋友嗎？,Sun Nov  1 00:45:47 2020
3,2,1,jump1230 (濕密爾),[問卦] 有沒有花蓮交通阿姨優先的八卦？,Sun Nov  1 10:00:12 2020
11,2,9,layu19920414 (Guan-Jie Huang),[問卦] SMAP最好聽的484世界に一つだけの花牙,Sun Nov  1 03:58:11 2020
6,1,5,MunezSu (Munez),[問卦] 台灣治安到底算不算好?,Sun Nov  1 08:51:53 2020
26,4,22,BlueGiant (極簡風格 藍巨人),[問卦] 為什麼任天堂不出高性能主機了？,Sun Nov  1 01:34:51 2020
22,6,16,aure0914 (tunik),[問卦] 小馮常常把椅墊坐到扁掉？,Sun Nov  1 02:30:30 2020
2,0,2,GOFEN (豬阿布),[問卦] 狗為何怕殺狗的人?,Sun Nov  1 03:11:54 2020
7,3,4,stank1240 (不發廢文的阿肥),[問卦] 把動保所的狗賣給對岸狗肉車可行嗎？,Sun Nov  1 04:36:14 2020
6,2,4,chan324 (北極熊),[問卦] 肥宅有啥優勢?,Sun Nov  1 03:03:43 2020
3,0,3,ikoy (？？？？),[問卦] 妹妹不讓我擦小穴該怎麼辦？,Sun Nov  1 10:25:31 2020
8,1,7,lamigo520 (菜市口阿勇),[問卦] 現在小朋友還知道陳浩南嗎？,Sun Nov  1 01:00:46 2020
2,1,1,tools (tools),[問卦] Ipod Shuffle該復刻了吧,Sun Nov  1 10:55:26 2020
2,6,-4,steven56138 (史蒂芬盒),[問卦] 遇到怪人腫摸辦,Sun Nov  1 02:25:59 2020
10,0,10,freeclouds (創造自己新的人生),[新聞] 隨機性侵殺人還洗劫 律師：判死機率相對,Sun Nov  1 10:41:14 2020
11,1,10,ptgeorge2 (左輪小手槍),[問卦] 讓支持廢死去養死刑犯可行嗎？,Sun Nov  1 09:18:34 2020
1,1,0,Jyery (文弟),[問卦] 有沒有越野跑配百岳越來越猛？,Sun Nov  1 10:37:09 2020
0,2,-2,tth9955 (EvilHeart),[問卦] 不許摸！,Sun Nov  1 10:37:12 2020
6,1,5,gn01765288 (PTT金庸),[問卦] 鬧這麼大 美豬進不了了吧?,Sun Nov  1 11:04:11 2020
3,2,1,songgood (ilovegoodgame),[問卦] 歧視法律人是全民運動吧？,Sun Nov  1 08:30:31 2020
4,3,1,zxc881230 (神槍手打手槍神),[問卦] 丹丹為何不來中部開店,Sun Nov  1 10:42:28 2020
4,5,-1,cirin (Cook),[問卦] 最大的悲哀不是壞人的猖狂而是好人的沉默,Sun Nov  1 01:45:33 2020
5,7,-2,oftisa (oo),[新聞] 陸媒：15年後 大陸人均GDP將達4至6萬美元,Sun Nov  1 10:28:18 2020
1,0,1,oz5566 (威廉。霍恩索倫),[問卦] 牛蛙是不是很可愛,Sun Nov  1 10:12:29 2020
4,1,3,e741000 (複利葉。腹便。幫浦拉絲),[問卦] 有人聽武統該怎麼辦,Sun Nov  1 09:04:17 2020
2,1,1,KahoJyumonji (Kahojyumonji),[新聞] 萬聖節嘉年華 士院院長扮禰豆子籲重視兒 ,Sun Nov  1 10:16:20 2020
1,0,1,Paul1021 (胡迪),[問卦] 台北市的治安相對其他縣市算比較好嗎,Sun Nov  1 00:37:10 2020
1,2,-1,teeheehee (軟尾拋拋翔(′・ω・`)),[問卦] 台灣有連環殺手嗎？,Sun Nov  1 09:48:44 2020
0,0,0,rick102233 (),[問卦] 女生有辦法性侵男生嗎？,Sun Nov  1 11:35:15 2020
5,1,4,LiarF7 (萊爾‧愛撫妻),[問卦] 客服月薪可以70k以上嗎？,Sun Nov  1 09:19:19 2020
6,4,2,sodistrues (true),[問卦] 鬧這麼大 死刑定了吧?,Sun Nov  1 10:53:06 2020
4,1,3,flower42 (栗悟飯與龜波功),[問卦] 欸幹 11月了欸,Sun Nov  1 08:38:47 2020
2,0,2,filmwalker (外面的世界),[新聞] 《鬼滅之刃》逼宮《冰雪2》 全台單日吸金,Sun Nov  1 10:01:43 2020
0,3,-3,A816 (♥七瀬丸的灰太狼♥),[問卦] 你們都不怕亂噓害人變成犯罪者？,Sun Nov  1 10:15:06 2020
0,11,-11,lovesaber (幻想神),[新聞] 鬼滅之刃逼宮冰雪2 全台單日吸金3500萬,Sun Nov  1 10:02:27 2020
17,1,16,Machienchien (倫家4女森捏><),[問卦] 糖豆人可以舉辦世界大賽嗎,Sun Nov  1 11:13:05 2020
4,0,4,thewtf (濱邊美波我老婆),[問卦] 遇到殭屍怎麼辦,Sun Nov  1 09:18:07 2020
4,4,0,foreverthink (曹雞拜振恰倪嵐),[問卦] 死刑了 然後呢？,Sun Nov  1 02:49:50 2020
2,1,1,arnold3 (憂鬱型男阿雲),[問卦] 為什麼東南亞人不支持廢死?,Sun Nov  1 01:25:57 2020
2,2,0,americ (americ),[問卦] 美國大法官6:3 戀同者 會入罪嗎,Sun Nov  1 01:57:59 2020
8,6,2,amy93 (silence),[新聞] 蔡總統賴副總統弔唁 朱冠甍女兒牙牙學語,Sun Nov  1 00:31:35 2020
12,0,12,G2S (貓貓好吃),[問卦] 當兵跑3000真的有3000公尺嗎?,Sun Nov  1 10:21:15 2020
6,5,1,belucky (),[問卦] 火屬性是不是比較好,Sun Nov  1 08:32:06 2020
27,63,-36,lovea (lovea),[新聞] 女大生命案「路燈不亮」所致　黃偉哲反,Sun Nov  1 09:30:38 2020
8,3,5,havochuman (嗨嗨嗨嗨嗨嗨),[問卦] 台灣有欠誰嗎?,Sun Nov  1 11:21:17 2020
0,0,0,tello (妳高興就好~),[問卦] 把人犯引渡給馬來西亞不就好了？,Sun Nov  1 11:31:26 2020
3,4,-1,seabox (盒盒),[公告] 八卦板板規(2020.10.11),Sun Oct 11 00:00:02 2020
8,1,7,moghtw11111 (如果我是迪杰),[問卦] Marvel 版是漫威版嗎？！,Sun Nov  1 08:44:23 2020
4,1,3,Cetuximab (單株),[問卦] 強姦殺人會判死刑定讞執行？,Sun Nov  1 10:38:11 2020
10,2,8,zzyyxx77 (討噓大師77),"[問卦] 慟..勇者阿邦死了= =""",Sun Nov  1 09:02:52 2020
9,6,3,cirin (Cook),"[問卦] 最近爛事一堆會有""我817我錯了""行動嗎?!",Sun Nov  1 09:48:49 2020
7,0,7,mossdevin (Devin Moss 10),[問卦] Pixel 5手機言過其實的八卦？,Sun Nov  1 09:22:51 2020
28,38,-10,hello456 (好無聊......),[新聞] 柯文哲暗酸蘇揆失智 政院：把疾病掛在嘴,Sun Nov  1 09:03:06 2020
3,0,3,maybetodo (np),[問卦] 不吃案但要養案怎麼算？,Sun Nov  1 00:32:11 2020
4,0,4,JHGF2468A (Joker),[問卦] 有沒有螢幕壞掉的八卦,Sun Nov  1 09:10:35 2020
6,0,6,LeonardoChen (LeonardoChen),[問卦] 如果道歉有用的話，要警察幹嘛？,Sun Nov  1 02:15:51 2020
27,8,19,mark999jrpan (安份坐在自己位子 ),[問卦] 有沒有摩羯座老闆硬到靠北的八卦?,Sun Nov  1 11:01:59 2020
6,1,5,CODDDD (好吃鱈魚高蛋白♡♡),[問卦] 168斷食包含禁食精液嗎,Sun Nov  1 03:18:09 2020
12,1,11,HuangJC (吹笛牧童),[問卦] 有沒有貓陪主人跑步的？ -- 陽光普照,Sun Nov  1 04:09:48 2020
4,1,3,ffdqfe (苦惱),[問卦] 買早餐遇到貓貓攔路怎辦？,Sun Nov  1 10:13:04 2020
35,2,33,xiikjuy (xiikjuy),[爆卦] 法國又發生恐攻?,Sun Nov  1 04:04:28 2020
5,1,4,NUMB43 (晚了~該睡了),[問卦] 半夜打死蚊子有違法嗎,Sun Nov  1 02:35:26 2020
6,0,6,became (windim),[問卦] 在我國偽出國要去哪好呢？,Sun Nov  1 08:26:08 2020
4,2,2,Aloee (柯粉),[問卦] 台灣導演想得獎就去拍甲甲片？,Sun Nov  1 11:22:26 2020
4,0,4,yi0116 (),[問卦] 柯孟杰是賣鞋霸主嗎,Sun Nov  1 03:22:41 2020
17,2,15,jay251935 (J.),[問卦] 現在哪裡還有五六百萬的透天?,Sun Nov  1 00:32:37 2020
14,3,11,s001582000 (洨軒),[問卦] 認真記帳一個月會改進花費習慣嗎,Sun Nov  1 02:06:03 2020
3,1,2,yangshaojiun (MATATA),[問卦] 吃飽了 然後呢？,Sun Nov  1 09:02:01 2020
4,0,4,sdtgfsrt (カヴァスⅡ世),[問卦] youtube實況是不是很吃資源阿?,Sun Nov  1 02:05:23 2020
12,3,9,doro0202 (Doro),[問卦] 我覺得我撐不下去了,Sun Nov  1 02:54:55 2020
16,2,14,olmtw (olmtw),[新聞] 確診人數突破百萬！政策大轉彎 英相強生,Sun Nov  1 08:38:51 2020
6,2,4,kinghole (安),[問卦] 為什麼法官很多重罪不判重刑？,Sun Nov  1 01:31:13 2020
7,7,0,Hiterler (希特勒),[問卦] 台灣人是不是很可悲？,Sun Nov  1 09:05:34 2020
7,0,7,king786945 (你看不見我),[問卦] 要去搭叫無限的火車,Sun Nov  1 00:28:19 2020
11,3,8,hltinokuo (甜甜-5樓/威秀影城1廳),[問卦] 有沒有家庭，假日在咖啡館待一整天的卦,Sun Nov  1 08:09:48 2020
7,4,3,"passing (0""_""0)",[問卦] 男生小團體多還是女生?,Sun Nov  1 00:51:21 2020
0,1,-1,ryohgi (青蛙錢包),[問卦] 有沒有人是「神關我屁事論者」,Sun Nov  1 11:27:09 2020
8,2,6,onepunchgg (onepunchgg),[問卦] A片網站影片設私人的人都是什麼心態= =,Sun Nov  1 10:57:03 2020
1,0,1,teeo (teeo),[問卦] 要怎樣站方才會開放註冊？,Sun Nov  1 01:39:15 2020
6,2,4,nk11208z (小魯),[問卦] 川普的Twitch沒人看了?,Sun Nov  1 02:20:15 2020
3,0,3,reticentcrow (沉默鴉),[問卦] 台灣為什麼疫情控制的那麼好,Sun Nov  1 10:42:15 2020
6,1,5,chonger (快樂人生),[問卦] 過年沒年味，但西方節日一堆活動,Sun Nov  1 00:38:00 2020
1,0,1,DALUGI (大陸雞),[問卦] 有沒有日本nissan的八卦?,Sun Nov  1 00:25:13 2020
0,1,-1,Kumasa (能不能畢業呢),[問卦] Gay是上帝創造的嗎？,Sun Nov  1 10:39:04 2020
18,4,14,taipei5566 (臺北56),[問卦] 大馬會對台灣開戰嗎？,Sun Nov  1 00:59:18 2020
209,3,206,twfir (N),[問卦] 日本居家住宅都用木頭建造算落後國家嗎??,Sun Nov  1 01:17:13 2020
3,8,-5,Lawleit (大員郭奉孝),[問卦] 「2020年怎麼了？」？,Sun Nov  1 09:22:19 2020
2,0,2,rafe (Out of the hole),[新聞] 美國大選出包 川普票倉賓州遺失上萬張,Sun Nov  1 06:30:48 2020
1,9,-8,joshddd (econ_apprentice),[問卦] 可以找三個法官同時判決嗎？,Sun Nov  1 01:21:35 2020
7,7,0,Emerson158 (紅豆 X 八嘎 X 烏魯賽),[問卦] 為何常有人衝康鬼金棒拉麵阿==?,Sun Nov  1 04:33:44 2020
3,0,3,hcn368 (私巴達),[新聞] 愛女遭擄殺客死他鄉...母盼嫌被判絞刑「,Sun Nov  1 03:04:03 2020
4,0,4,HappyDiD (開心的動一動),[問卦] 衣服洗成荷葉邊還會穿嗎？,Sun Nov  1 06:57:01 2020
8,5,3,moneybuy (),[問卦] 鬼滅之刃無限列車過譽嗎?,Sun Nov  1 00:26:58 2020
10,0,10,EggXBlueSky (laughTree),[問卦] 25歲薪水應該多少？,Sun Nov  1 02:43:20 2020
6,0,6,doro0202 (Doro),[問卦] 線上博弈這麼夯怎麼不實體化？,Sun Nov  1 00:56:08 2020
15,1,14,joynet0306 (Joe),[情報] 徵求行車記錄器,Tue Oct 27 12:44:53 2020
4,3,1,nemies (...),[問卦] 網友告訴我一個秘密,Sun Nov  1 00:50:25 2020
7,1,6,bbob (小海),[問卦] 有錢人玩的什麼興趣大家最想嘗試看看?,Sun Nov  1 09:59:36 2020
9,1,8,bamama56 (bamama),[問卦]  盡情揮灑自己的色彩 年輕不要留白,Sun Nov  1 07:48:15 2020
15,12,3,hoyumi (正版型男...無誤!!!),[新聞] 扯！載屍加油沒錢 嫌竟拿女大生手機抵債,Sun Nov  1 01:42:10 2020
3,1,2,shala (沙羅是轉換後的文字檔打m),[問卦] 每年股利500萬是甚麼感覺?,Sun Nov  1 10:03:07 2020
5,5,0,saufu08 (saufu),[問卦] 犯下姦殺真不怕女鬼回來報仇？,Sun Nov  1 10:32:45 2020
1,3,-2,Lumial020 (廢貓文專用帳號),[問卦] 乙級諾卡達？,Sun Nov  1 01:07:09 2020
3,6,-3,SWS7983 (G坂本),[問卦] 嗚嗚是在嗚什麼意思？,Sun Nov  1 09:47:12 2020
3,0,3,Pixma258 (鄉民們!別爭了!!),[問卦] 台灣藝人誰適合演佐為？,Sun Nov  1 11:21:31 2020
7,11,-4,chen5566 (文心),[問卦] 為什麼殺害歹徒有罪？,Sun Nov  1 00:51:54 2020
3,1,2,lauwei (lauwei),[問卦] 跟台南的台男交往要注意什麼？,Sun Nov  1 11:25:37 2020
9,2,7,singking (),[問卦] 在公共泳池游仰式的在想什麼？,Sun Nov  1 11:03:23 2020
0,9,-9,gentleman888 (),[新聞] 蘇起憂民進黨 營造獨尊台獨言論市場,Sun Nov  1 09:03:22 2020
5,0,5,akanishiking (arnold jackson),[問卦] 萬聖節最簡單的cosplay是不是麥可麥爾斯,Sun Nov  1 09:18:28 2020
0,0,0,redspeed (RED),[問卦] 真的有那麼多沾血棋盤可以撿?,Sun Nov  1 11:35:01 2020
5,0,5,samuelcmm (黃宏誠天空之誠世界猥瑣),[問卦] 有法官家人被殺的八卦嗎？,Sun Nov  1 09:02:03 2020
2,0,2,yahoo3936 (老唐 是你?),[問卦] 預算五萬 新手入門卡打車怎麼買,Sun Nov  1 09:55:32 2020
3,1,2,sunskies (suica card),[問卦] 小六女生真的會喜歡這種車？,Sun Nov  1 07:55:05 2020
15,14,1,iamgaylan (),[問卦] 大家覺得這些人數前五的國家治安好嗎,Sun Nov  1 08:20:20 2020
6,0,6,willyover (烤肉!),[問卦] 跟風老警察吃案,Sun Nov  1 09:03:30 2020
10,3,7,kawhidurantt (kawhi durant),[問卦] 希望川川當選,Sun Nov  1 09:11:59 2020
2,0,2,WORLDKING56 (王者中間五六),[問卦] 慶記擄人之都是不是換人了？,Sun Nov  1 09:17:40 2020
4,6,-2,wang1b (唯i廢文<3),[問卦] 拉麵的海苔是幹嘛的？,Sun Nov  1 01:16:56 2020
1,1,0,sleepyuan (文源),[問卦] 在以色列總理辦公室做愛怎樣?,Sun Nov  1 08:48:49 2020
7,0,7,abiese05 (AB),[問卦] 菲律賓人現在在想什麼,Sun Nov  1 08:28:23 2020
14,4,10,joanzkow (星浪),[新聞] 金馬導演張毅病逝！享壽69歲,Sun Nov  1 10:27:49 2020
1,3,-2,amilkamilk (),[問卦] 是不是完全不能反對同志？,Sun Nov  1 08:01:26 2020
3,0,3,herbert0716 ((っ・ω・)っ),[問卦] 有沒有XP娘的八卦？,Sun Nov  1 10:37:52 2020
2,1,1,rockon15 (水之呼吸－炭治郎),[問卦] 晴女的生意有搞頭嗎？,Sun Nov  1 09:12:23 2020
4,0,4,sodistrues (true),[問卦]跟美波合拍廣告的櫻花妹在日本人氣算高？,Sun Nov  1 09:29:08 2020
32,10,22,frzqp3814396 (咩咩咩咩咩),[問卦] 歐美人士只要喊愛台灣就有飯吃？,Sun Nov  1 05:34:54 2020
6,2,4,kid725 (凱道基德),[新聞] 馬籍女學生遇害案 蘇貞昌道歉 要求改善治安,Sun Nov  1 03:02:34 2020
27,3,24,EXGG (皮蛋榴槤),[問卦] 泱泱真的是天然呆傻大姊嗎？！,Sun Nov  1 02:04:09 2020
5,3,2,taiwannext (2016綠營重新執政 ),[問卦] 馬來西亞華人比較多學中文簡體字？ ,Sun Nov  1 09:51:14 2020
0,1,-1,b777787 (想不到8),[新聞] 貧窮線將升 北市25K列中低收入戶,Sun Nov  1 09:55:32 2020
17,9,8,obov5116 (慶記市第一金城武尊),[問卦] 168斷食，一直睡不著？,Sun Nov  1 03:05:25 2020
2,0,2,z1976 (z1976),[問卦] 請問租車好還是買車好?,Sun Nov  1 06:39:53 2020
0,0,0,icefish712 (冰魚),[問卦] 女生問你在幹嘛 ,Sun Nov  1 11:32:17 2020
2,6,-4,happysingle (happysingle0803),[問卦] 夜店都玩這麼嗨嗎？,Sun Nov  1 11:22:48 2020
0,0,0,Hivwing (飛羽),[新聞] 拜登民調持續領先《華爾街日報》：民主黨,Sun Nov  1 11:33:19 2020
1,1,0,yangzy (亞瑟),[新聞] 酸蘇貞昌失智！柯文哲拒道歉：別裝傻,Sun Nov  1 11:16:04 2020
3,8,-5,ivorysoap (ivorysoap),[新聞] 不甘被男醫要求肉償賭債 女護士殺人烹屍被判死刑,Sun Nov  1 01:14:18 2020
4,0,4,aurior (ari),[新聞] 王隆昌獲北科大校務發展卓越貢獻獎,Sun Nov  1 10:41:53 2020
9,0,9,hushiang (我練功發自真心),[問卦] 老人很愛說：吃這麼鹹要洗腎嗎？,Sun Nov  1 11:04:34 2020
8,1,7,foreverthink (曹雞拜振恰倪嵐),[問卦] 該說台南綁人那個嫌犯算誠實嗎,Sun Nov  1 01:27:53 2020
46,15,31,XXXXGGYY ((4X鮑)),[新聞] 同志上告白警察徵友 警員竟留言5字下場被,Sun Nov  1 10:15:05 2020
1,1,0,ilw4e (可以吃嗎？),[問卦] 川普什麼時候說過白人至上?,Sun Nov  1 09:42:03 2020
2,2,0,ntlutw (Louis888),[問卦] 有罪，但當庭釋放？,Sun Nov  1 04:57:05 2020
1,0,1,hoyumi (正版型男...無誤!!!),[問卦] 你說的出五年前發生的大事嗎？,Sun Nov  1 00:33:48 2020
44,4,40,coga4712 (海森堡),[問卦] 黑袍糾察隊推薦嗎？,Sun Nov  1 00:35:10 2020
6,7,-1,medlife0830 (allen game),[新聞] 擄殺女大生！變態魔認了「先性侵後殺人,Sun Nov  1 10:43:14 2020
1,5,-4,MeeToo (迷途),[問卦] 法律人是不是很難當很為難,Sun Nov  1 09:18:49 2020
24,4,20,Workforme (′‧ω‧‵),[新聞] 為了討回五萬元債務...惡煞街頭暴力討債,Sun Nov  1 05:26:57 2020
5,1,4,s505015 (s505015b大),[新聞] 放任校安死角！長榮大學「未依規定通報」,Sun Nov  1 10:32:57 2020
8,1,7,WWIII (東邪西毒),[問卦] 今天健身房人好少 有什麼活動？,Sun Nov  1 00:36:15 2020
9,5,4,IamCuteGirl (CuteGirl5566),[問卦] 犯罪連坐全家的話 會抑制犯欲嗎,Sun Nov  1 09:50:06 2020
8,4,4,shampoopoo (毛寶洗髮精),[問卦] 肥宅有啥優勢?,Sun Nov  1 03:32:56 2020
4,2,2,odasaku (鹹魚),[問卦] 這個天氣484很適合曬被被,Sun Nov  1 09:24:34 2020
0,0,0,xinyi101 (小愛茶),[問卦] 知道一號鐵雄請注意的人都幾歲了,Sun Nov  1 11:33:58 2020
13,3,10,razghot1597 (卡拉姆恰),[問卦] 廢死是聖人嗎？,Sun Nov  1 08:49:53 2020
7,1,6,x6073123 (),[問卦] iPhone是不是真香,Sun Nov  1 03:31:03 2020
2,1,1,tommyshu (ranger00),[問卦] No Nut November你能持續幾天,Sun Nov  1 00:48:24 2020
9,18,-9,redspeed (RED),[新聞] 蔡總統召開國安高層會議 就五大面向作出,Sun Nov  1 10:44:19 2020
1,0,1,sodistrues (true),[新聞] 黎智英助理坦承參與拜登之子醜聞造假 深,Sun Nov  1 10:11:38 2020
1,0,1,zxc8424 (我無法忍受你的行為),[問卦] 學弟說的弱受睡姿是什麼東西？,Sun Nov  1 00:31:44 2020
7,1,6,XXXXGGYY ((4X鮑)),[問卦] 明天開會跟老闆說時空背景不同會怎麼樣?,Sun Nov  1 10:43:35 2020
0,0,0,hayate232 (CY),[問卦] 多喝水降體脂肪?,Sun Nov  1 01:26:09 2020
6,3,3,Lawleit (大員郭奉孝),[問卦] 梁嫌車上一堆內褲 為啥女學生內褲不拿走,Sun Nov  1 03:03:16 2020
3,2,1,sole772pk37 (咬我阿豬),[問卦] 有沒有早期捐血的八卦,Sun Nov  1 09:19:13 2020
2,2,0,ltytw (拉米亞妹妹),[問卦] 萍哥拍片時講台語會更棒嗎,Sun Nov  1 08:16:25 2020
0,0,0,hmenri (擺爛心得大師),[問卦] 妳是我的花朵當年多紅,Sun Nov  1 09:54:44 2020
5,0,5,isagoo (古先生),[問卦] 為什麼居住正義這件事情一直被魯蛇扭曲？,Sun Nov  1 10:03:13 2020
7,0,7,q5212 (q5212),[問卦] 狗為何怕殺狗的人?,Sun Nov  1 01:40:07 2020
1,3,-2,takuminauki (史迪格里茲粉),[問卦] 驚!! BLACKPINK居然有口水,Sun Nov  1 00:31:06 2020
16,5,11,GhostFather (鬼父Oni Chichi),[問卦] 為什麼剛剛PTT會斷線？,Sun Nov  1 05:27:23 2020
10,1,9,uilmas1 (品味寂寞入迷中),[問卦] 拜登之子的醜聞新聞是假的新聞？！,Sun Nov  1 10:01:37 2020
27,2,25,whiteadam (blue eyes blue),[問卦] 莫文蔚最經典的歌是?,Sun Nov  1 01:17:16 2020
2,4,-2,awdxabc295 (憤世嫉俗的肥宅),[問卦] 我們是不是都該要有包容的心？,Sun Nov  1 08:36:26 2020
2,1,1,lunqun35 (Sweet Caroline),[問卦] 大學跟男友同居的台女現在在幹嘛？,Sun Nov  1 00:30:13 2020
3,2,1,purue (purue),[問卦] 酸痛噴什麼最有效,Sun Nov  1 07:37:15 2020
27,2,25,bennyalen (小周),[問卦] 許久沒見的妹子突然聯絡是什麼意思？,Sun Nov  1 01:18:08 2020
2,1,1,plutox (網路上的芳鄰),[問卦] 請小妹妹吹冷氣大會受歡迎嗎？,Sun Nov  1 03:09:01 2020
7,7,0,as6633208 (okokokiknow),[問卦] 交了女朋友之後，就有點想耍廢了？,Sun Nov  1 08:45:54 2020
6,5,1,cheermin (客體錯誤),[問卦] 有沒有訂外送還要被嗆可憐的八卦,Sun Nov  1 11:17:21 2020
3,1,2,inmee (J),[問卦] 麥當勞炸雞腿比肯德基大支的八卦?,Sun Nov  1 00:33:31 2020
71,14,57,GGINDOWBOW (吃肥肥裝頹頹),[問卦] 大家對台南的標準是不是太高了,Sun Nov  1 09:12:05 2020
4,2,2,g318 (^___^),代號「X-,Sun Nov  1 07:34:46 2020
15,5,10,kingtama (立志成為唬爛王),[問卦] 殺外國人為什麼政府要道歉？,Sun Nov  1 08:14:28 2020
2,5,-3,justice0616 (你學長),[問卦] 獅子跟大象大家誰贏？,Sun Nov  1 02:53:15 2020
4,0,4,mazinkisa (kisa),[問卦]現在的美乃滋或沙拉比怎麼甜那麼多啊! ,Sun Nov  1 06:54:01 2020
8,3,5,kent (大屌肯特),[新聞] 女同學怕房內靈異哭聲？邀男同學分床睡 ,Sun Nov  1 09:55:30 2020
15,4,11,edwardsyo (愛德華),[問卦] 法律人是不是很難當很為難,Sun Nov  1 09:12:46 2020
10,1,9,Ironstick (鋼鐵蛇),[問卦] 妹子明明住樓上卻一直搞錯的八卦,Sun Nov  1 04:49:30 2020
6,2,4,superRKO (挖洗RKO),[問卦] 為啥美國投票是在平日？,Sun Nov  1 02:02:00 2020
4,0,4,Kimmy (Kimi),[問卦] 景嵐怎麼不上極智對決惹?,Sun Nov  1 10:01:37 2020
0,0,0,ilovettb (笑著笑著就哭了),[新聞] 北市男童裸身疑遭虐未安置 目前仍與生父繼母住,Sun Nov  1 00:29:16 2020
7,1,6,chen0625 (不知道要打什麼？),[問卦] 外送員一單是拿多少？,Sun Nov  1 10:23:48 2020
10,2,8,neiltsang (楚留香雞排),[問卦] 早餐吃卦包  亦包  幹怎麼打拉  會很肥ㄇ,Sun Nov  1 06:55:38 2020
234,53,181,Wojnarowski (@wojespn),[新聞] 酸蘇貞昌失智！柯文哲拒道歉：別裝傻,Sun Nov  1 10:21:26 2020
14,5,9,kingtama (立志成為唬爛王),[問卦] 家屬可以要求國賠了吧？,Sun Nov  1 08:34:51 2020
2,0,2,ivorysoap (ivorysoap),[問卦] 台南最近多災多難 是不是肉臊飯害的？,Sun Nov  1 09:59:08 2020
10,0,10,q10242 (黑田祐司),[新聞] 萊豬大戰 柯文哲嗆鬼扯：公文是溝通還是,Sun Nov  1 10:42:13 2020
88,34,54,leafshot (5566),[新聞] 隨機性侵殺人還洗劫 律師：判死機率相對,Sun Nov  1 10:23:17 2020
3,2,1,Beanoodle (津崎似超人平匡先生),[問卦] 上海圖書館很有名嗎?,Sun Nov  1 01:05:51 2020
8,0,8,Burney000000 (六零波尼),[問卦] 台灣人沒房是不是自找的啊,Sun Nov  1 08:48:03 2020
4,0,4,Ejaculation (小易),[問卦] 美選會有奧步嗎,Sun Nov  1 10:32:13 2020
296,47,249,kid725 (凱道基德),[新聞]柯文哲對同志示好?北市府2021舉辦亞洲平權,Sun Nov  1 06:50:33 2020
2,1,1,Paul1021 (胡迪),[問卦] 住101旁邊很衰小的卦,Sun Nov  1 00:45:49 2020
3,1,2,mucorn (MU),[問卦] 土耳其地震台灣不去嗎？,Sun Nov  1 11:03:22 2020
4,3,1,oscarwu3041 (夢想家的羽毛),[問卦] 是什麼令我對你難以忘懷？,Sun Nov  1 03:40:05 2020
30,11,19,westdoorcard (West),[問卦] 財經仙女力挺大陸：在台灣很悶,Sun Nov  1 10:01:52 2020
37,2,35,tasty678 (tasty678),[新聞] 美國單日確診破10萬 刷新全球紀錄,Sun Nov  1 08:11:53 2020
4,2,2,azt911231 (),[問卦] 從防治精神疾病社會安全網,Sun Nov  1 07:59:03 2020
12,5,7,abc12812 (),[問卦] 姦殺女大生犯人打99通電話來的及嗎?,Sun Nov  1 02:00:48 2020
86,48,38,tt7642 (你睏),[問卦] 是不是完全不能反對同志？,Sun Nov  1 07:27:39 2020
30,2,28,linwahaha (),[新聞] 貧窮線將升 北市25K列中低收入戶,Sun Nov  1 02:54:13 2020
3,0,3,laptic (靜夜聖林彼岸花),[問卦] 馬來西亞華人比較多學中文簡體字？,Sun Nov  1 10:52:59 2020
8,0,8,CrazyStar09 (小安),[新聞] 全台僅5處！ 士東市場、南門市場、寧夏夜,Sun Nov  1 10:07:39 2020
2,1,1,qazStarStar (我不是派大星),[問卦] 台南未來那個區發展會比較好？,Sun Nov  1 05:26:12 2020
4,1,3,Superxixai (洪粉吱已),[問卦] 震驚片！超巨大豆輪,Sun Nov  1 08:41:25 2020
6,3,3,ptt987654321 (),[新聞] 吃飯AA制的都渣男？他「一番話」全戰翻：,Sun Nov  1 10:39:38 2020
17,2,15,wbsinger (罪愛死奴屄),[新聞] 台北男求職不順！撕毀「12.6萬紙鈔」往,Sun Nov  1 10:40:41 2020
22,2,20,a0953781935 (),[問卦] 客服月薪可以70k以上嗎？,Sun Nov  1 09:14:33 2020
8,2,6,kenny1300175 (蘇湖),[新聞] 家屬慟：規劃來台參加畢典變認屍,Sun Nov  1 07:56:12 2020
4,0,4,hareluyac (還我清新廢文八卦版),[問卦] 中國人怕鬼愛講八卦西洋人也怕鬼愛講八卦,Sun Nov  1 10:02:27 2020
4,0,4,wnglon (冷面笑匠),[問卦] iphone 12 跟XR哪個cp值高？,Sun Nov  1 05:32:18 2020
12,2,10,PrinceKanto (生田絵梨花は俺の嫁),[新聞] 竹科工程師七年之癢床戰前女友5天 保險套,Sun Nov  1 10:54:33 2020
4,3,1,APUDOOR (APUDOOR),[問卦] 台南殺人案是不是先噓法官,Sun Nov  1 02:30:56 2020
11,2,9,radiotofu (電台豆腐),[問卦] 大耳狗和KiKi LaLa要怎麼選？,Sun Nov  1 00:51:04 2020
29,14,15,sakaba (早起的鳥兒),[新聞] 英媒：金正恩興建70層高樓 逼工人吸毒趕進度,Sun Nov  1 01:37:30 2020
4,1,3,mark751019 (☆比哈士奇帥一點☆),[問卦] 當初的法官錄取有用公務員外省保障名額嗎?,Sun Nov  1 04:20:02 2020
0,0,0,FacialHairTz (鬍踢記),[問卦] 有沒有幻覺的八卦,Sun Nov  1 00:29:13 2020
1,2,-1,XXXXGGYY ((4X鮑)),[問卦] 大家看到JK會不會想尿尿?,Sun Nov  1 10:09:21 2020
9,10,-1,bencert (根本ㄏㄏ),[問卦] 台科在普大中略輸成大小贏中央？,Sun Nov  1 01:07:11 2020
9,5,4,ss311tw (戰神東方祥),[問卦] 日輪刀被砍斷了怎麼辦,Sun Nov  1 08:26:39 2020
8,3,5,lpbrother (LP哥(LP = Love & Peace)),[問卦] 警察拿到破案獎金通常怎麼花？,Sun Nov  1 07:27:19 2020
8,0,8,moneybuy (),[問卦] 史比特瓦根集團跟中川集團哪個有錢?,Sun Nov  1 01:00:25 2020
202,14,188,SmallCave (沉寂濕漢),[爆卦] 潭子深夜大火,Sun Nov  1 01:40:21 2020
3,10,-7,zzyyxx77 (討噓大師77),[新聞] 教育部前下跪！蔡阿嘎突喊「對不起大家」,Sun Nov  1 11:25:11 2020
106,6,100,dunking (秋高氣肅),[爆卦] 天鵝颱風成為21世紀以來的風王,Sun Nov  1 03:26:29 2020
14,1,13,hlvj (Fly Phoebe),[新聞] 英國首相宣布英格蘭即將進入2次全國封鎖,Sun Nov  1 05:29:15 2020
24,7,17,hittler (西斯特),[問卦] 每年股利是甚麼感覺?,Sun Nov  1 09:25:30 2020
1,3,-2,y3226999 (咪苦說她喜歡我 >///<),[問卦] 女同學的夢想,Sun Nov  1 01:36:23 2020
5,1,4,Vicky1016 (蜜雪),[新聞] 《經濟學人》預測：川普勝選機率只剩4%,Sun Nov  1 06:19:24 2020
4,1,3,sofaly (沙發椅),[新聞] 柯文哲暗酸蘇揆失智 政院：把疾病掛在嘴,Sun Nov  1 10:07:53 2020
5,1,4,vikk33 (vikk33),[問卦] 吃案怎麼吃?,Sun Nov  1 09:53:33 2020
2,0,2,iComeInPeace (匹——嘶！),[問卦] 螢幕使用時間這樣算乖寶寶嘛,Sun Nov  1 08:42:53 2020
1,0,1,eugenehi22 (最開心的事:笑看腦殘蛆蛆),[問卦] 當初抗爭不要捷運經過的居民現在在想什,Sun Nov  1 10:16:08 2020
2,3,-1,JC910 (JC910),[問卦] 自然形成的夜市484比人工夜市好太多了,Sun Nov  1 10:34:10 2020
0,0,0,cwh0105 (Ex咖哩棒),[問卦] 拜登當選美國會變成蘿莉之國嗎?,Sun Nov  1 11:31:11 2020
15,34,-19,sonyabear (忍魯腹重),[問卦] 妹妹不讓我擦小穴該怎麼辦？,Sun Nov  1 07:59:25 2020
15,2,13,swatch44 (Dr.No),[問卦] 暗網最殘忍影片是哪部?,Sun Nov  1 11:04:59 2020
0,1,-1,songgood (ilovegoodgame),[問卦] 男主為何還要跟乙女姐結婚,Sun Nov  1 08:43:30 2020
0,0,0,analiya (莉雅),[問卦]川普任命大法官將讓他順利連任美國總統？,Sun Nov  1 11:34:30 2020
3,3,0,Greedguilty (落合),[問卦] 怎樣的油條才算是合格,Sun Nov  1 03:00:38 2020
2,2,0,radiotofu (電台豆腐),[問卦] 日本女高三生有多大？,Sun Nov  1 09:11:34 2020
3,2,1,Aloee (柯粉),[問卦] 怎麼向大馬人傳遞台灣can help的訊息,Sun Nov  1 10:42:00 2020
8,1,7,kinjk01 (小白),[問卦] 線上博弈這麼夯怎麼不實體化？,Sun Nov  1 00:30:16 2020
6,2,4,chen5566 (文心),[問卦] 為什麼台灣配音版不用台語？,Sun Nov  1 08:50:07 2020
0,1,-1,qwqwaas (MADE),[問卦] 氣泡水打開後能放多久?,Sun Nov  1 08:37:37 2020
4,3,1,RLAPH (川尻浩作),[問卦] 幹比自己小11歲的女生  會有罪惡感嗎,Sun Nov  1 02:00:21 2020
6,2,4,currry (南港李國毅),[問卦] 持修金音獎摃龜原因竟是...,Sun Nov  1 10:21:31 2020
11,6,5,fnm525 (Pluie céleste),[問卦] 我發現了永動機了！！！,Sun Nov  1 03:35:10 2020
2,0,2,Qoo2222 (Qoo2222上來說是 但是缺3),[問卦] 現在還會缺流感疫苗嗎???,Sun Nov  1 11:11:31 2020
11,3,8,pchion2002 (阿我就怕被罵阿),[問卦] 便利商店先開瓶喝 再結帳 可以？,Sun Nov  1 10:39:05 2020
140,38,102,oceanplus (plus++),[新聞] 一家最後合照曝　女大生媽淚：台灣還我女,Sun Nov  1 11:05:25 2020
0,0,0,ILike58 (小菊花),[問卦] 有沒有肌動減脂的八卦？,Sun Nov  1 10:44:50 2020
8,5,3,addison123 (鄉下小鮮肉),[問卦] 欸，馬來西亞女大生在中國被姦殺會？,Sun Nov  1 11:29:36 2020
3,0,3,ReiFu21 (ReiFu),[問卦] MP5 vs 集氣槍 vs 能量槍 vs 火箭筒,Sun Nov  1 10:02:28 2020
5,0,5,nuturewind (自然風),[問卦] 說到史恩康納萊你會想到(最喜歡)哪部電影,Sun Nov  1 00:49:52 2020
5,2,3,ryusenming ( ),[問卦] 很窮有正妹女友跟有點錢沒女友會選哪個?,Sun Nov  1 11:23:11 2020
7,1,6,edwardsyo (愛德華),[問卦] 島耕作是不是運氣好的社畜公司狗渣男,Sun Nov  1 08:58:49 2020
4,0,4,GonVolcano (火山君),[問卦] 有沒有台灣人常常在看病的掛,Sun Nov  1 11:04:42 2020
24,4,20,yuanisme (www),[問卦] 釣蝦釣半天ㄧ隻都沒釣到 求解,Sun Nov  1 01:50:50 2020
14,2,12,pp771017 (橫艾),[問卦] 萬聖節最沒創意的造型是蜘蛛人嗎？,Sun Nov  1 07:39:18 2020
132,29,103,safelove (安全的愛),[問卦] 鬧這麼大 死刑定了吧?,Sun Nov  1 10:46:37 2020
0,0,0,LiaMeow (有時候甜蜜的心花朵朵開),[新聞] 一家最後合照曝　女大生媽淚：台灣還我女,Sun Nov  1 11:32:40 2020
7,15,-8,tatty5566 ( ),[問卦] 聽說這裡打嘻嘻就會被噓？,Sun Nov  1 00:44:12 2020
42,37,5,ubcs (覺★青年超冒險蓋),[公告]十月份置底閒聊區      ,Wed Oct  7 16:57:26 2020
34,19,15,lpbrother (LP哥(LP = Love & Peace)),[新聞] 今抵台接愛女 父母慟不再來傷心地 女大,Sun Nov  1 10:25:37 2020
107,1,106,lockingsong (),[問卦] 起司可以算是最空虛的食物,Sun Nov  1 00:39:23 2020
11,0,11,bennyalen (小周),[問卦] 女生：突然想到你，是什麼意思？,Sun Nov  1 11:21:15 2020
27,11,16,littlethe (東周流浪漢),"[問卦] 為什麼第一次馬來西亞女生被殺時,不轟動?",Sun Nov  1 09:38:11 2020
5,4,1,yji3vu4gj4 (YJI),[問卦] 台北人沒錢買藍芽耳機？,Sun Nov  1 08:52:28 2020
1,7,-6,sunskies (suica card),[問卦] 如何讓哥哥不要接近我的小穴？,Sun Nov  1 08:08:02 2020
2,4,-2,shampoopoo (毛寶洗髮精),[問卦] 有Serj Tankian 的八卦咪,Sun Nov  1 00:25:17 2020
3,1,2,josherion (Josh),[問卦] 我們與惡的距離的王律師,Sun Nov  1 11:25:03 2020
0,0,0,Alertme (-.-),[問卦] 你們都不怕亂噓害人變成犯罪者？,Sun Nov  1 11:34:24 2020
0,0,0,dasuininder (硬派大叔),[問卦] 廢死仔是不是只會出一支嘴啊,Sun Nov  1 11:32:18 2020
2,1,1,seiya2000 (風見),[問卦] 八卦鄉民理財觀是不是很差,Sun Nov  1 10:43:57 2020
9,4,5,freeclouds (創造自己新的人生),[新聞] 國安高層會議｜蔡英文向北京喊話　「及,Sun Nov  1 01:11:01 2020
5,0,5,tml7415 (國民黨不倒 台灣不會好),[問卦] 大家對台南的標準是不是太高了,Sun Nov  1 10:17:53 2020
33,13,20,luxuryer (),[新聞] 他告白警察遭諷「玫瑰捅屁眼」　高雄警被,Sun Nov  1 10:07:23 2020
7,0,7,stjchl (潮王鄭成功),[問卦] 1664缺貨的八卦,Sun Nov  1 00:51:08 2020
3,0,3,smileboy2016 (Sand Tree Pad),[問卦] 近視與日光燈照明有關嗎？,Sun Nov  1 10:13:41 2020
8,2,6,Vicky1016 (蜜雪),[新聞] 川普取消大選夜慶功晚會 當晚留在白宮,Sun Nov  1 06:33:33 2020
8,0,8,asas1asas200 (廢文製造者),[問卦] 有親子專用車廂為什麼沒有兒童禁止車廂,Sun Nov  1 08:44:42 2020
30,12,18,zoosleep (王者),[新聞] 愛女遭擄殺客死他鄉...母盼嫌被判絞刑「,Sun Nov  1 00:43:39 2020
12,4,8,silentknight (清純男),[問卦] E奶美女學姊 找我當她SWAG影片男主角,Sun Nov  1 11:01:39 2020
4,1,3,Jasonbon (),[問卦] 台南 跟 台男 哪個容易上新聞,Sun Nov  1 10:09:55 2020
7,0,7,TESA (TESA),[問卦] EMT1可以幹嘛？,Sun Nov  1 10:12:31 2020
11,3,8,shala (沙羅是轉換後的文字檔打m),[問卦] 大家覺得這些人數前五的國家治安好嗎,Sun Nov  1 09:23:30 2020
3,1,2,kennetharies (阿K),[問卦] 一堆名人搶扮炭治郎，扮上三不是比較帥,Sun Nov  1 11:28:11 2020
2,0,2,chot (C-hot),[新聞] 林佳龍任台大國發所客座講師 談政府創新,Sun Nov  1 09:28:20 2020
8,2,6,ivorysoap (ivorysoap),[新聞] 女大生命案「路燈不亮」所致　黃偉哲反,Sun Nov  1 09:48:33 2020
2,2,0,bezbol (o.o),[問卦] 零安樂死 X 廢死，然後呢？,Sun Nov  1 10:59:39 2020
2,0,2,wnglon (冷面笑匠),[問卦] 新北 台中 台南 高雄哪邊瘋子多？,Sun Nov  1 05:19:34 2020
10,5,5,DoncicInPTT (東七七玩批踢踢),[問卦] 仇女、仇甲、單身、肥宅交集為什麼會這麼,Sun Nov  1 10:50:46 2020
3,0,3,STAV72 (刁民黨黨務主委),[新聞] 脂肪結構成為防禦機制，細胞運用脂肪滴,Sun Nov  1 11:28:30 2020
10,0,10,ato0715 (熊),[爆卦] 台北市2015年1月至今故意殺人數 全國第一,Sun Nov  1 09:53:38 2020
16,1,15,lamigo520 (菜市口阿勇),[問卦] 分手時做過什麼事情？,Sun Nov  1 08:22:55 2020
0,0,0,lichuer (Z揪兒),[問卦] 重點根本不是死刑而是司法改革吧==,Sun Nov  1 11:31:00 2020
49,14,35,Birthday5566 (生日5566),[問卦] 長榮女大生案，政府該如何補救？,Sun Nov  1 09:43:50 2020
3,0,3,Dinenger (低能兒),[問卦] 今晚的蓮蓬頭在想什麼？,Sun Nov  1 01:30:33 2020
11,0,11,minifat (迷你肥辦公室),[問卦] 醫師都怎麼選老婆,Sun Nov  1 00:28:25 2020
5,0,5,maybetodo (np),[問卦] 當路燈不亮會想到誰呢？,Sun Nov  1 09:58:04 2020
2,2,0,teeheehee (軟尾拋拋翔(′・ω・`)),[問卦] 快艇隊沒事搬來有湖人隊的洛城是怎樣==？,Sun Nov  1 09:29:25 2020
5,2,3,taiwan08 (save the one for all),[新聞] 叫外送火鍋「太新鮮」...他尷尬開涮變公,Sun Nov  1 10:42:08 2020
4,5,-1,y3226999 (咪苦說她喜歡我 >///<),[問卦] 虐待初音會怎樣嗎==？,Sun Nov  1 01:16:58 2020
9,1,8,slovea (YiYinKing),[問卦] 一直夢到獨角獸正代表什麼,Sun Nov  1 11:07:55 2020
1,0,1,bg00004 (絕緣體),[問卦] 殺外國人為什麼政府要道歉？,Sun Nov  1 08:26:13 2020
1,0,1,horse5566lee (魅力型男★☆黃敬堯☆★),[問卦] 台灣戒嚴時期的中將算很威嗎？？,Sun Nov  1 01:02:46 2020
9,7,2,Lawleit (大員郭奉孝),[問卦] 同志大遊行有多少是同志？,Sun Nov  1 02:41:36 2020
13,9,4,iam4k (im4k),[問卦] 這麼廢的部長留著幹嘛？,Sun Nov  1 10:54:49 2020
2,0,2,andy199113 (Andy),[問卦] 爆氣！有沒有 youtube-dl 被下架的八卦？,Sun Nov  1 02:41:33 2020
13,0,13,akway (生活就是要快樂),[新聞]從小美到大！女神黑嘉嘉11歲超萌嫩照曝光,Sun Nov  1 09:02:57 2020
1,1,0,Qorqios (☁銀長直傲嬌JK☁),[問卦] 有沒有家庭，假日在咖啡館待一整天的卦,Sun Nov  1 08:49:24 2020
14,3,11,zxc881230 (神槍手打手槍神),[問卦] 預算五萬 新手入門卡打車怎麼買,Sun Nov  1 09:44:11 2020
19,11,8,defendor007 (阿里巴巴我在這),[問卦] 歧視法律人是全民運動吧？,Sun Nov  1 08:29:02 2020
1,0,1,zapzone (問卦大師),[問卦] 發燒,Sun Nov  1 10:05:43 2020
4,13,-9,shpongle (夜空中最亮的星),[新聞]川普下 拜登上就能撥亂反正?克魯曼:好天真,Sun Nov  1 00:37:57 2020
2,0,2,praiseZun (praiseZun),[問卦] 川普的youtuber頻道競選影片,Sun Nov  1 01:38:27 2020
1,3,-2,aynmeow5566 (艾喵56),[問卦] 法輪功難道不怕得罪美國嗎,Sun Nov  1 00:40:16 2020
39,15,24,nobody0303 (),[問卦] 沒人覺得一輩子工作很可怕嗎！,Sun Nov  1 01:35:06 2020
1,1,0,KH21 (氫化鉀21),[新聞] 狠奪人命！梁育誌鬆口：性侵後才勒斃鍾女,Sun Nov  1 00:22:30 2020
1,0,1,a11111a4210 (clh),[問卦] 有台南殺人犯啥時可以吃豬腳麵線的卦?,Sun Nov  1 11:26:32 2020
3,1,2,gay7788 (卡稱之神=卡神),[問卦] 隔壁屋頂有人在唱歌腫膜棒,Sun Nov  1 00:29:31 2020
5,1,4,firelemon (魯魯修),[問卦] 擄肉犯之都,Sun Nov  1 09:25:04 2020
0,0,0,adidas52088 (阿軒把醜話說在前頭，「),[問卦] 獵人是不是也該畫劇場版？,Sun Nov  1 11:32:56 2020
1,1,0,gologo (),[問卦] 周星馳的武打實力?,Sun Nov  1 09:05:31 2020
0,0,0,foreverthink (曹雞拜振恰倪嵐),[新聞] 英媒：金正恩興建70層高樓 逼工人吸毒趕進度,Sun Nov  1 01:59:58 2020
5,2,3,sushi11 (偶像可以亂摸嗎peko),[問卦]  拜拜可以選擇拜魔關羽嗎,Sun Nov  1 00:49:29 2020
7,6,1,hahaopen (chun),[問卦] 月收10萬  要選全存  還是交2個以上女友,Sun Nov  1 09:54:18 2020
14,0,14,Kimmy (Kimi),[問卦] 台灣藝人誰適合演佐為？,Sun Nov  1 11:10:20 2020
2,0,2,s510410 (雨漫窗台),[問卦] Line 484壞掉了,Sun Nov  1 06:56:55 2020
14,16,-2,muchmany (citycafe),[新聞] 財經網美：「我個性可能變大陸人了」認在,Sun Nov  1 10:14:19 2020
4,2,2,kronioel (鵝妹子英),[新聞] 長榮女大生命案 成馬來西亞華文媒體頭版,Sun Nov  1 10:01:06 2020
2,0,2,kuijun228 (Daoko小粉絲),[問卦] 台南芒果干,Sun Nov  1 02:13:25 2020
9,0,9,icro111 (大色胚),[新聞] 女大生命案被質疑吃案　黃偉哲駁：如果,Sun Nov  1 07:57:30 2020
33,13,20,tarcy2767 (小紅帽找大野狼),[新聞]韓黑譏人少 罷捷總部貼出「超震撼照片」,Sun Nov  1 07:10:45 2020
10,4,6,hiball (魔鬼肥肉人),[問卦] Pixel 5手機言過其實的八卦？,Sun Nov  1 09:11:47 2020
2,2,0,covenant (藍悠),[問卦] 什麼情境下會管不住懶叫？,Sun Nov  1 11:19:28 2020
38,6,32,ivorysoap (ivorysoap),[新聞] 放任校安死角！長榮大學「未依規定通報」,Sun Nov  1 10:16:34 2020
14,14,0,s785602 (s785602),[問卦] 老高是不是顯露本性了?,Sun Nov  1 00:38:03 2020
12,8,4,LoveMakeLove (ボケ),[新聞]為何台灣畫不出鬼滅之刃這樣的漫畫？網曝,Sun Nov  1 08:06:02 2020
4,5,-1,smileboy2016 (Sand Tree Pad),[問卦] FedEx航線很愛穿越台灣核心上空？,Sun Nov  1 06:56:18 2020
3,1,2,Cocochia (我是閃電經濟學家),[問卦]  蛀牙是醫生沒有盡到醫生的責任？,Sun Nov  1 05:33:54 2020
37,4,33,iamshana (CANINE力集中在一些重要S),[新聞] 2020高中生最愛十大好書 《台北人》連,Sun Nov  1 10:32:08 2020
10,1,9,oftisa (oo),[問卦] 川普什麼時候說過白人至上?,Sun Nov  1 09:06:23 2020
28,10,18,kenzo (kenzo),[新聞] 女大生遭擄殺案早能避免？他怒嗆黃偉哲,Sun Nov  1 10:13:11 2020
9,1,8,xup6xu6 (一人一隻雞翅膀),[問卦] 任天堂御三家是哪三家？,Sun Nov  1 08:06:13 2020
5,2,3,plutox (網路上的芳鄰),[問卦] 鬼滅動畫是不是低素質的在看？,Sun Nov  1 08:28:45 2020
2,2,0,Mariano42 (Mariano Rivera),[新聞] 美海豹6隊奈及利亞顯神威救援人質 川普：,Sun Nov  1 02:28:59 2020
8,3,5,ForTheHorde (為了部落！),[問卦] 看到祖國人在大廈頂端打手槍怎麼辦?,Sun Nov  1 03:43:41 2020
13,0,13,chun0303 (chun),[新聞] 愛琴海強震後艾爾段感謝各國祝福 包括台,Sun Nov  1 08:37:52 2020
37,10,27,dodo52woman (嘟嘟左右衛門),[問卦] Gay是上帝創造的嗎？,Sun Nov  1 07:03:34 2020
3,11,-8,Dimihaha (ㄅㄑ),[問卦] 哪一版老人最多?,Sun Nov  1 01:03:13 2020
20,8,12,leon105 (@@),[新聞] 美戀童士官拐13歲女回軍營！　「性侵虐6,Sun Nov  1 08:14:38 2020
2,2,0,oceanplus (plus++),[問卦] 梁嫌車上一堆內褲 為啥女學生內褲不拿走,Sun Nov  1 02:31:57 2020
16,3,13,ytkuang (就是那個光),[新聞] 別跟錢過不去！失業男撕鈔票出氣 判罰13,Sun Nov  1 10:37:38 2020
1,1,0,minifat (迷你肥辦公室),[問卦] 警察都怎麼選老婆,Sun Nov  1 00:35:23 2020
5,0,5,Usayhiisayha (【〖《〔（{`}）〕》〗】),[問卦] 沒想到我白眉鷹王今天？,Sun Nov  1 08:31:52 2020
0,0,0,opemhood (大漢堡),[問卦] 要當棋子還是塞子？,Sun Nov  1 10:00:29 2020
0,0,0,CavendishJr (真禮梅西姐姐♡),[新聞] 為掌握疫情擴大情況 日本擬進行第二次萬,Sun Nov  1 11:35:38 2020
2,0,2,mossdevin (Devin Moss 10),[問卦] 老師教英文的八卦,Sun Nov  1 08:05:40 2020
2,5,-3,RS5566 (懶叫好吃^Q^),[問卦] 剛剛想到襪子套屌不夠噴,Sun Nov  1 02:20:29 2020
6,4,2,fawangching (陽光宅叔),[問卦]  全球 什麼時候 才能恢復 正常出國？,Sun Nov  1 08:53:19 2020
3,3,0,bluebagel (果果:)),[問卦] 半夜的uber eat可以點什麼？,Sun Nov  1 00:31:25 2020
5,3,2,Ed860227 (Phag125),[問卦] 廢死應該不是為了人權吧？,Sun Nov  1 02:50:18 2020
27,11,16,M5D (舒跑套水更好喝),[新聞] 台鐵斷軌初步調查出爐 林佳龍要求11月底,Sun Nov  1 06:51:49 2020
7,0,7,GraceMa (我喜歡騎馬),[問卦] 在台灣女生一定要化妝嗎,Sun Nov  1 02:15:17 2020
9,3,6,ak904 (AK),[新聞] 川普被當垃圾丟掉了 杜莎夫人蠟像館選前,Sun Nov  1 11:18:55 2020
1,1,0,kalaokla (卡啦),[問卦] 美國打美式足球晚年會不會很可憐?,Sun Nov  1 10:23:15 2020
7,1,6,gentleman888 (),[問卦] 肥宅到路燈不亮的地方需要提高警覺嗎？☺,Sun Nov  1 09:51:42 2020
9,24,-15,hoanbeh (初入江湖淨添堵),[新聞] 陸媒：15年後 大陸人均GDP將達4至6萬美元,Sun Nov  1 10:21:00 2020
5,0,5,tiger911 (胖虎),[新聞] 貧窮線調高 北市月入25Ｋ算貧戶,Sun Nov  1 09:31:07 2020
6,3,3,whiteadam (blue eyes blue),[問卦] 有木有胰臟癌的八卦?,Sun Nov  1 01:01:33 2020
4,16,-12,bradpete (姆咪輪班星人),[問卦] 因為感情而睡不著484很菜,Sun Nov  1 03:09:18 2020
3,2,1,magicbook123 (魔法書),[問卦] 歐洲大強子對撞機跟核能四廠哪個浪費錢？,Sun Nov  1 10:15:10 2020
1,0,1,jakelinlien (jake),[問卦] 所以改孟買好不好,Sun Nov  1 00:29:27 2020
1,0,1,sleepyuan (文源),[問卦] 在伊朗總統府做愛會怎樣?,Sun Nov  1 07:12:42 2020
2,0,2,cattgirl (baby yumi),[問卦] 基督教學校出人命 為什麼教牧不負責?,Sun Nov  1 11:30:03 2020
141,113,28,O26RZ (O26RZ),[爆卦] 台北市2015年1月至今故意殺人數 全國第一,Sun Nov  1 09:01:23 2020
12,6,6,neiltsang (楚留香雞排),[問卦] 幹 我突然悟道了..(真理在此 俗人勿近),Sun Nov  1 07:25:15 2020
4,0,4,jasd1786 (假橡膠樹),[新聞] 9個月前算出全球陷危機！印度神童再預言,Sun Nov  1 10:32:42 2020
3,1,2,mkjay00000 (大隻的肥羊),[問卦] 社會安全網有三小屁用？,Sun Nov  1 01:54:26 2020
2,4,-2,onetiger (一虎),[問卦] 有沒有止屁的偏方,Sun Nov  1 01:13:32 2020
16,12,4,blue999 (民國詩人-Blue居易),[問卦]民主國家 為什麼會被少數廢死團體綁架多數,Sun Nov  1 02:21:23 2020
10,2,8,relax911 (Lmerro),[新聞] 英國確診突破百萬 英相宣布一個月禁足令,Sun Nov  1 08:03:17 2020
6,6,0,Qorqios (☁銀長直傲嬌JK☁),[問卦] 我老婆變石頭了該怎麼辦？,Sun Nov  1 00:22:42 2020
2,9,-7,soheadsome (師大狗鼻哥),[問卦] 哇靠 旅展熱褲妹超多,Sun Nov  1 11:29:33 2020
0,6,-6,JUNOCARE (陽光！！),[問卦] 有人到現在還沒看鬼滅之刃電影版的嗎??,Sun Nov  1 01:38:47 2020
1,1,0,todao (心裡有數),[問卦] 讓支持廢死去養死刑犯可行嗎？,Sun Nov  1 10:35:08 2020
2,0,2,ivorysoap (ivorysoap),[問卦] 有遊戲間 點心間 休息間的公司真的存在嗎,Sun Nov  1 01:29:07 2020
5,5,0,addison123 (鄉下小鮮肉),[問卦] 今天甲甲大遊行還會戴屌襪上嗎？,Sun Nov  1 07:02:47 2020
2,0,2,three88720 (不要跟我起爭yee啦!),[問卦] 有沒有No Nut November的卦,Sun Nov  1 00:24:05 2020
3,2,1,YAYA6655 (YAYA),[問卦] 金正恩到底怎麼了？,Sun Nov  1 02:13:26 2020
12,18,-6,cliffcliff (號：),[新聞] 台南將軍虱想同樂會熱鬧 黃偉哲：台南是,Sun Nov  1 00:26:41 2020
32,172,-140,Dinenger (低能兒),[問卦] 死刑了 然後呢？,Sun Nov  1 02:14:36 2020
0,0,0,petingo (皮挺哥),[問卦] 夢到台積電漲到 900 多,Sun Nov  1 11:32:55 2020
24,16,8,Aruka0924 (Aruka),[新聞] 擄殺女大生！變態魔認了「先性侵後殺人,Sun Nov  1 10:37:00 2020
1,0,1,jimgene (jimgene),[問卦] 有遊戲間 點心間 休息間的公司真的存在嗎,Sun Nov  1 01:22:02 2020
4,1,3,OusakaMegumu (逢坂恵夢),[新聞]緬因州首採「排序投票」計票複雜恐需2周,Sun Nov  1 10:02:44 2020
4,1,3,surimodo (搖滾少女!! 活力棉花糖!!),[問卦] 為什麼FB YT詐騙都不管？,Sun Nov  1 01:59:12 2020
2,3,-1,CuLiZn5566 (同理心5566),[爆卦] 超越連戰的舉球手出現啦！,Sun Nov  1 09:26:55 2020
10,6,4,Ejaculation (小易),[問卦] 台中治安第一是真的吧,Sun Nov  1 01:38:04 2020
0,0,0,ilanese (我寫故我在),[問卦] 有沒有「史密斯菲爾德食品公司」的八卦？,Sun Nov  1 00:26:35 2020
10,2,8,nobody0303 (),[問卦] 為何煙味這麼難聞還有人抽煙抽得下去！,Sun Nov  1 02:13:39 2020
7,4,3,john5380 (),[新聞] 太遲？！暗黑便道全亮了　警車大陣仗巡邏,Sun Nov  1 04:17:12 2020
33,5,28,indoman (橄欖趴),[問卦] 台灣為什麼疫情控制的那麼好,Sun Nov  1 10:33:02 2020
6,2,4,hittler (西斯特),[問卦] 殺人是高雄人干台南屁事?,Sun Nov  1 11:27:11 2020
6,2,4,anger312143 (anger),[問卦] 鬼滅主角耳環是旭日旗嗎？,Sun Nov  1 05:20:34 2020
7,0,7,Tono6812 (深海鯰魚),[問卦] 在台灣如何成為客家人領袖,Sun Nov  1 10:51:22 2020
5,2,3,tony900735 (安西街教練),[問卦] 全家為何不排2個店員當班？,Sun Nov  1 11:21:24 2020
2,2,0,GhostFather (鬼父Oni Chichi),[問卦] 歐美人士只要喊愛台灣就有飯吃？,Sun Nov  1 06:22:50 2020
0,0,0,Emacs (打馬小蝦兵),[問卦] 所以，現在出路都要帶手電筒嗎？,Sun Nov  1 11:37:28 2020
23,6,17,deepdish (Keep The Faith),[新聞] Uber司機有前男友的fu　她一時情迷…清,Sun Nov  1 06:40:34 2020
2,0,2,remmurds (Stronghold),[問卦] 台男一出事 肥宅就帶風向？,Sun Nov  1 11:24:25 2020
1,3,-2,takashi01 (中和孔劉),[問卦] 全世界都在玩公主連結你有什麼理由不玩,Sun Nov  1 11:10:58 2020
79,13,66,KKmex (麥克斯),[新聞] 萊豬大戰 柯文哲嗆鬼扯：公文是溝通還是,Sun Nov  1 10:17:28 2020
0,0,0,keyesleo (以前曾經很帥),[問卦] 乙級諾卡達？,Sun Nov  1 01:49:28 2020
3,0,3,abc12812 (),[問卦] 與惡會怎麼翻拍姦殺案犯人?,Sun Nov  1 02:20:03 2020
64,13,51,Ho1liday (江湖唯有英雄志),[問卦] 900元便當？（圖）,Sun Nov  1 01:36:11 2020
9,3,6,IamCuteGirl (CuteGirl5566),[問卦] 會在Qtime做愛的都是啥階層,Sun Nov  1 04:17:52 2020
4,2,2,belucky (),[問卦] 廢死的邏輯？,Sun Nov  1 02:42:41 2020
5,2,3,iam4k (im4k),[問卦] 學店這下是不是雪上加霜了？,Sun Nov  1 10:12:11 2020
70,9,61,Ryo5566 (),[新聞] 快訊／台南四草大橋「男子墜海」！目擊,Sun Nov  1 09:19:17 2020
